111111111111111111111111111 S 11111111111
1                                       1
1                         11111111      1
1111111 1111111111111111111      1      1
1     1 1                         1     1
1     1 1                          1    1
1     1 1                           1   1
1     1 1                            1  1
1     1 1                             1 1
1                                      11
1                                       1
1                                       1
1                                       1
1                                       1
1                                       1
1                                       1
1                                       1
1                                       1
1                                       1
1                                       1
11111111111111111111111111111 F 111111111